SO ./textures/greystone.cub


EA ./textures/red.cub

F 00,50,89

NO ./textures/eagle.cub



C 7,65,21


WE ./textures/purplestone.cub



11111111111111111111111111111111
111111111000000000000000011111
10000000010000000011100010011
110000100000000000000000011111
1000011111110W0000000011111
11111111110000000000000001111111111
11110000001100000000000011100111111
11111111111111111111111111111111
1100000000000111100001   100001111111
10000000000111000000001111011111111
1100000000001110000000000111100111111
11000000000111000000000000111111111111
11111111111111111111111111111111