SO ./textures/sud.xpm
EA ./textures/est.xpm
NO ./textures/north.xpm
WE ./textures/west.xpm
F 211,211,211
C 163,206,220


111111111111111111111111111111111111111
100000000000000000000000000000000000001
101111111111111100111111111111111111101
101000000000000100100000000000000000101
101011111111110100101111111111111110101
10101000000001010010100000E000000010101
101010111111010100101011111111110010101
101010100001010100101010000000010010101
101010101101010100101010111111010010101
101010101101010101101010100001010010101
101010101101010100101010101101010010101
101010101101010100101010101101010010101
101010101100000100100000001100010010101
101010101111111100111111111111110010101
101010100000000000000000000000000010101
101010111111111111111111111111111110101
101010000000000000000000000000000000101
101011111111111111111111111111111111101
100000000000000000000000000000000001001
111111111111111111111111111111111111111
