SO ./textures/sud.xpm
EA ./textures/est.xpm
NO ./textures/north.xpm
WE ./textures/west.xpm
F 0,0,0
C     255,255,255



11111111111111111111111111111111111111
100000000000000000000000000000000000001
101111111111111100111111111111111111101
101000000000000100100000000000000000101
101011111111110100101111111111111110101
101010000000010100101000000000000010101
101010111111010100101011111111110010101
101010100001010100101S10000000010010101
101010101101010100101010111111010010101
111110000000000000000000000000000000011111
101010101101010101101010100001010010101
111110000000000000000000000000000000011111
101010101101010100101010101101010010101      
10101010110101010101010101101010010101      		      
101010101100000100100000001100010010101
101010101111111100111111111111110010101
101010100000000000000000000000000010101
101010111111111111111111111111111110101
101010000000000000000000000000000000101
101011111111111111111111111111111111101
100000000000000000000000000000000001001
111111111111111111111111111111111111111
111111111111111
100000000000011
111111111111111