SO ./textures/greystone.cub

EA ./textures/red.cub

F 100,211,251

NO ./textures/eagle.cub

C 7,0,5

WE ./textures/purplestone.cub


11111111111111111111111111111111
111111111000000000000000011111                         1
10000000010000000011100010011                         101
110000100000000000000000011111                         1
1000011111110S0000000011111
1111111111000000000000001111111111
11110000001100000000000011100111111
111111111111111111111110111111111      11
1100000000000111100001 1 100001111111
1000000000011100000001 1 1111011111111
10000000000000000000011110000000001
1100000000001110000000000111100111111
11000000000111000000000100111111111111
11111111111111111111111 11111111