SO ./textures/sud.xpm
EA ./textures/est.xpm
NO ./textures/north.xpm
WE ./textures/west.xpm
F 211,211,211
C 163,206,220


11111111111111111111111111111111
111111111000000000000000011111                         1
10000000010000000011100010011                         101
110000100000000000000000011111                         1
100001111111000000000011111
1111111111000000000000001111111111
11110000001100000000000011100111111
111111111111111111111110111111111      11
1100000000000111100001 1 100001111111
1000000000011100000001 1 1111011111111
10000000000000000000011110000000001
11000000000011100E0000000111100111111
11000000000111000000000100111111111111
11111111111111111111111 11111111