SO ./textures/greystone.cub

EA ./textures/red.cub

F 100,211,251

NO ./textures/eagle.cub

C 7,0,5

WE ./textures/purplestone.cub

11111111111111
1000E000000001
10000000000001
11111111111111