SO ./textures/greystone.cub

EA ./textures/red.cub

F 100,211,251

NO ./textures/eagle.cub

C 7,0,5

WE ./textures/purplestone.cub

111111111111111111
100000000001111111
11110000000000001
111100000000011111
1111000000000001
1111000S00000001
111100000011111
111111111111111111