SO ./textures/wallSouth.xpm
EA ./textures/wallEast.xpm
NO ./textures/wallNorth.xpm
WE ./textures/wallWest.xpm







F 211,211,211			
C 163,206,220


           

			1111111111111111111
			10000000000000000001
			10000000000000000001
			10000000000000000001
			10000000000000000001
			10000000011000000001
			10000000011000000001
			10000000010000000001
			100000001N1000000001
			10000000010000000001
			10000000000000000001
			11111111111111111111

