SO ./textures/spid_noir.xpm
EA ./textures/eye_red.xpm
NO ./textures/spid_gris.xpm
WE ./textures/eye.xpm

F 0,0,0
C 255,180,220

 111
 1S11
11011111111111111111
11011000000000000001
11011000101111111001
11011111101000000101
11000000000000000101
10111111111000000101
10000000011000000101
10001100010000000101      
10001100011011111101
10000000000000000001
