SO ./textures/est.xpm
EA ./textures/sud.xpm
NO ./textures/murcolor.xpm
WE ./textures/murcolor.xpm
F 211,211,211
C 163,206,220



11111111111111111111
10000000000000000001
10000000000000000001
10000000000000000001
10000000000000000001
10000000011000000001
10000000011000000001
10000000000000000001
100000000S0000000001
10000000000000000001
10000000000000000001
11111111111111111111