SO ./textures/greystone.cub
EA ./textures/red.cub
NO ./textures/eagle.cub
WE ./textures/purplestone.cub

F 163,206,220
C 100,211,251


11111111111111111111
10000000000000000001
1111000000000000001
1000000000001000001
1111100000011000001
1000000000000000011
1W00000000000000011
11111111111111111111