SO ./textures/greystone.cub

EA ./textures/red.cub

F 100,211,251

NO ./textures/eagle.cub

C 7,0,5

WE ./textures/purplestone.cub

11111111111111111111
10000000000000000001
11110000000111100001
10000000000111100001
11111000000000000001
10000000001100000001
10000000000000000001
11111111111111111111